NO imgs/xpm/wall/default_junglewood.xpm
SO imgs/xpm/wall/default_junglewood.xpm
EA imgs/xpm/wall/default_junglewood.xpm
WE imgs/xpm/wall/default_junglewood.xpm
F 255,0,0
C 0,0,255

11111111111111
1001000000000ft_strdup1
10010000000001
10010000000001
10000000000011
10000000000001
100000E0000001
10000000010001
11110000010001
10000000011111
10000010000001
10000010000001
11111111111111
