NO imgs/xpm/blueWall64x64.xpm
SO imgs/xpm/blueWall64x64.xpm
EA imgs/xpm/blueWall64x64.xpm
WE imgs/xpm/blueWall64x64.xpm
F 255,0,0
C 0,0,255
KEY 50,50

11111111111
10000000031
10000N00001
10000000001
10000000001
10000200001
10000000001
10000000001
10000000001
11111111111