NO ./path_to_the_north_texture
SO ./path_to_the_south_texture

WE      ./path_to_the_west_texture

EA   ./path_to_the_east_texture



F  220,100,0
C    225,30,0



           1111111111111
           1000000100001
           1101111100011
           1001010000001
           1011010000111
           1000010000001
           1100110000011
           1000000001001
           1000110001011
           1000010000001
           1000000011101
           1000000001001
           1110000001011
           1000000001001
111111111111111110000011
10100000100010001000000111111
10000110111010111000000010101
10000000101000000000000000001
10000000100001100000000111111
10000010000000000000000000001
11000111000000000111000000111
10000010001000000000000010001
11000110001000000001111111001
10000000001010001000100000001
10000000001011111100100111111
10000000001010001000100010001
10000000001110101010110010011
10000000001000101010000010001
10000010000010101010100010001
11111111111111111111111111111
