NO imgs/xpm/blueWall64x64.xpm
SO imgs/xpm/blueWall64x64.xpm
EA imgs/xpm/blueWall64x64.xpm
WE imgs/xpm/blueWall64x64.xpm
F 255,0,0
C 0,0,255
KEY 128,400
KEY 150,400
LAMP 192,400
HEAL 256,400
FULL_HEAL 320,400
BONUSHP 384,400
ENERGY 448,400
BIG_ENERGY 512,400
MAP 566,400

11111111111
100E0000031
10000000001
10000000021
10000000001
10000000001
10000000001
10000000001
10000000001
10000000001
10000000001
10000000001
10000000001
10000000001
10000000001
10000000001
10000000001
10000000011
1000000001
10000000011
10000000001
10000000001
10000000001
10000000001
10000000001
10000000001
10000000001
10000000001
10000000001
10000000001
10000000001
10000000001
10000000001
10000000001
10000000001
11111111111
