NO imgs/xpm/wall/default_junglewood.xpm
SO imgs/xpm/wall/default_junglewood.xpm
EA imgs/xpm/wall/default_junglewood.xpm
WE imgs/xpm/wall/default_junglewood.xpm
F 255,0,0
C 0,0,255
KEY 50,50

11111111111
10000000031
10000000001
10010000001
10010000001
10020000W01
10010000001
10000000001
10000000001
10000000001
10000000001
10000000001
10000000001
10000000001
10000010101
10000000001
10000000001
10000000001
10000000001
10000000001
10000000001
10000000001
10000000001
10000000001
10000000001
10000000001
10000000001
10000000001
10000000001
10000000001
10000000001
10000000001
10000000001
10000000001
10000000001
11111111111