NO imgs/xpm/wall/default_junglewood.xpm
SO imgs/xpm/wall/default_junglewood.xpm
EA imgs/xpm/wall/default_junglewood.xpm
WE imgs/xpm/wall/default_junglewood.xpm
F 255,0,0
C 0,0,255
KEY 384,384
KEY 384,384
ENERGY 400,400

11111111111
10000000031
11000000001
11000000001
11000000001
120W0000001
11000000001
11000000001
11000000001
10000000001
10000000001
10000000001
10000000001
10000000001
10000010101
10000000001
10000000001
10000000001
10000000001
10000000001
10000000001
10000000001
10000000001
10000000001
10000000001
10000000001
10000000001
10000000001
10000000001
10000000001
10000000001
10000000001
10000000001
10000000001
10000000001
11111111111