NO ./imgs/xpm/test.xpm
SO ./imgs/xpm/test.xpm

WE      ./imgs/xpm/test.xpm

EA    ./imgs/xpm/test.xpm



C    225,30,0
F  220,100,0



11111111
1000011
10000011
10000011
10000011
10000011111111111
10000000000000011
1000001111111111
10000N11
11111111
