NO imgs/xpm/blueWall64x64.xpm
SO imgs/xpm/blueWall64x64.xpm
EA imgs/xpm/blueWall64x64.xpm
WE imgs/xpm/blueWall64x64.xpm
F 255,0,0
C 0,0,255
KEY 128,400
LAMP 192,400
HEAL 256,400
FULL_HEAL 320,400
BONUSHP 384,400
ENERGY 448,400
BIG_ENERGY 512,400
GHOST 512,900

11111111111
10000000031
10000S00001
10000000001
10000000001
10000000001
10000000001
10000000001
10000000001
10000000001
10000000001
10000000001
10000000001
10000000001
10000000201
10000000001
10000000001
10000000001
10000000001
10000000001
10000000001
10000000001
10000000001
10000000001
10000000001
10000000001
10000000001
10000000001
10000000001
10000000001
10000000001
10000000001
10000000001
10000000001
10000000001
11111111111