NO ./imgs/xpm/blueWall64x64.xpm
SO ./imgs/xpm/redWall64x64.xpm

WE      ./imgs/xpm/greenWall64x64.xpm

EA    ./imgs/xpm/purpleWall64x64.xpm



C    225,30,0
F  220,100,0

11111111111111111111111111111111111                         
10000010000010101010101000100010001                         
11101110100110101000000000001110001                         
10100000100000100000000000001000001                         
10000000000110000000000000001110111                         
10000000000000000000000010000010101                         
10000000001111000000000010000000001                         
10000010000010001010000000001000001                         
11000010011110001110000000101100011                         
10000010000010100000101000100000001                         
11001110011111111010101011100000011                         
10000000001010001010100010001000001                         
11101000000010101011100000001100111                         
10001010000000100000001000001000001                         
11111011100000111100111100011000011                         
10101010100000001000101000001000001                         
10101010100000000000100001100000001                         
10001000100010000000000000100000001                         
11111111100111100000000001110000001                         
10000000100010101000001000000000001                         
10111000111000101000001100000000001                         
10101000000000101010000000000010001                         
101011111100001010100000001111100011111111111111111111111   
100000000000101010100000000000001000101010101010001010001   
101110111100101011100000000000001100001000100010001000001   
101000100000101000101000000000101000001000100010101000001   
111111111111111111111100000001111000000000101110101100101   
                     100000000101000000000001000100000101   
                     110000000001111000001101010100000111   
                     100100010001010000000101010100010001   
                     110100111100010000010101010101010001   
                     100000010100111111111111111111111111   
                     1011111101101                          
                     1000000000001                          
                     1101010100111                          
                     1001010100001                          
                     1111011100001                          
                     1000010100001111111                    
                     1000000100110000001                    
                     1000000100000001001                    
                     1100001110000001111                    
                     1000000000000001001                    
                     1110001101110000001                    
                     1000000101010000001                    
                     1000110111011000011                    
                     1000000000010000001111111111111111     
                     1110000101110011110100010101000101     
                     1000000100000001000000000000010001     
                     1000111101100000010000001111011111     
                    11000000101000100010100000001010001     
                    10000000000000111011111000001010001     
                    10000000000N00001000101000001010001     
                    11000000000001100010001000001111111     
                    10000000101000000010001000000000001     
                    10110011101001111110111000000010111     
                    10000010001000001000000010000010001     
                    11001111111000001000000011001010101     
                    10000000001000001010001010001010101     
                    10101010101010101010101000001010101     
                    11111111111111111111111111111111111
