NO ./imgs/xpm/blueWall64x64.xpm
EA ./imgs/xpm/redWall64x64.xpm

WE      ./imgs/xpm/wall626x626.xpm

SO    ./imgs/xpm/wall626x626.xpm



C  255,0,0
F  0,0,255

11111111111111
10000000000001
10000000000001
100N0000000001
10000000000001
10000000000001
10000000000001
10000000000001
10000000000001
10000000001111
10000000001001
10000000001001
11111111111111