NO imgs/xpm/wall/default_junglewood.xpm
SO imgs/xpm/wall/default_junglewood.xpm
WE imgs/xpm/wall/default_junglewood.xpm
EA imgs/xpm/wall/default_junglewood.xpm
C 37,37,37
F 110,110,110
KEY 864,100
KEY 737,1490
KEY 935,1821
KEY 555,482
KEY 879,342
KEY 469,1182
      1111111111    
      1000001001    
      1000001001    
      1000000001    
      1111111001    
      1000001001    
      1211111001    
      1000001001    
      1100001001    
      1000002001    
      1000111001    
      1000100001    
      1111100011    
      1000000001111 
      1000000000001 
      1S00000000001 
      1210000000001 
      1010000000001 
      1010000000001 
      1310000000101 
      1110121110101 
      1010100010001 
      1011101110001 
     11010001000001 
     10011111211111 
     100100000000011
     100000000000001
     100000000000001
     100000000000001
     111111111111111
