NO ./imgs/xpm/blueWall64x64.xpm
SO ./imgs/xpm/redWall64x64.xpm

WE      ./imgs/xpm/greenWall64x64.xpm

EA    ./imgs/xpm/purpleWall64x64.xpm



C    225,30,0
F  220,100,0




        11111111111111111111111111111111111111111           
        10100010001000001000000010100000100010101           
        10000110001010011011111000110000000110111           
        10000000100010000010101000100000000000001           
        10000111111111000000001110000011111111101           
        10000000100010000000001000000010100000101           
        11000011100000000000001110000010100000001           
        10000010000000001000000010S00000100010001           
        10000010110001101000000111111001110011001           
        10001010000000101010000000000000100000001           
        11101011100000111010000011001010000000011           
        10101000101000001000000010001010000000001           
        10001010001010100000000011101111000111001           
        11111111111111111110001000100010000000001           
                          10011011101010000011001           
                          10000000101000000000001           
                          10000111100000000000001           
                          10100000100000000000001           
   1111111111111111111111110100110111100101111111           
   1001010000010001000001000000010001000101                 
   1101000011000000011111000000011101000111                 
   1000000001000000010000000100000101000001                 
   1011000001111101111100001110000101100001                 
   1001010000000100010100000000000100000101                 
   1111111111111110110111010000111111111111                 
                 10000001010000001                          
                 11100101110110011                          
                 10000101000000001                          
                 11000101110111111                          
                 10000100010000001                          
                 10001100010110001                          
                 10000100000000001                          
                 11000110011110011                          
                 10010000010100001                          
                110110100000101011                          
                10001010000010100111111111111111111111111   
                10001110000111101000000010100000101000001   
                10000010100010001000000000000010000000001   
                11100010111110000000001110110011000000001   
                10001000001000000000001010100010001000001   
                11001000000000001100011111111111111111111   
                1000101000001000100001                      
                1010001100001100100011                      
                1111110000101000101001                      
                     11001100011111111                      
                     10000000000000001                      
                     11100000000111111                      
                     10000001010100001                      
                     10000001010111111                      
                     11110000010000001                      
                        11111010100011                      
                        10100010100001                      
                        1011101110011111111111              
                        1000100010001010001001              
                        1110111011000000000001              
                        1000101000000000000001              
                        1100101011000111100011              
                        1000101010000010001001              
                        1000101000100010101001              
                        1111111111111111111111 
