NO imgs/xpm/wall/default_junglewood.xpm
SO imgs/xpm/wall/default_junglewood.xpm
WE imgs/xpm/wall/default_junglewood.xpm
EA imgs/xpm/wall/default_junglewood.xpm
C 37,37,37
F 110,110,110
KEY 356,938
KEY 733,734
KEY 83,784
KEY 1130,879
KEY 926,913
KEY 992,109
1111111111111111111 
1000S00000000010001 
1000111000110000111 
1000100000100000001 
1000111000100000111 
1000000000000000101 
1000000011100000101 
1010000010000000101 
1111101111101111101 
1000100000001000001 
1000100000111000001 
1000100000100010301 
1011100000111211111 
1020000000001020001 
1010000000001011111 
1010000000000000001 
1110111011111010001 
1000001000102010001 
1100001000111010011 
100000100000000001  
111100100000000001  
   100000000000001  
   100000000111011  
   100000000100001  
   100111011111101  
   100000000101001  
   101100000121001  
   100100000101001  
   100001000000001  
   111111111111111
