NO ./imgs/xpm/blueWall64x64.xpm
SO ./imgs/xpm/redWall64x64.xpm
WE ./imgs/xpm/greenWall64x64.xpm
EA ./imgs/xpm/purpleWall64x64.xpm

C 225,30,0
F 220,100,0
                           111111111111111111111111         
                           100001000000000101000001         
                           101111000S00000100000001         
                           100000000000000000000101         
                           111100000000001100001111         
                           100100000000000000000001         
                           101100000011001110000011         
                           100000000001000100000001         
                           111101111101100111000011         
                           100100010100000001000001         
                           110101110100000011001111         
                           100000010001000001000101         
                           111000011111100001100101         
                           100001000000000100000101         
                           111111011110001111111101         
                           100000010100000000000101         
                           110001110000111001111111         
                           100001000000000000000001         
                           101111100000000000000001         
       11111111111111111111100000000000000001010001         
       10010101010101000000011001100011000111010111         
       100101000000010001010100010000000100000101           
       101100011101111111011100011110001110000001           
       100000000101010001000000000000000100011111           
       11011111110001000111010000111110000101               
       10010001000001000100010000000000000101               
       11110011100001111101111001111000000001               
       10010001000000000101010001010000000001               
       11011101110111010101011101000110000001               
       10000100010101010001000101000000000101               
       11111111000101110111110000001111000111               
       10000000000101000000010000000101000001               
       10010101000000010001111111111101001111               
       11111111111111111000010000000001000001               
                       1011011101100000011111               
                       1001000101000000010001               
                       1100000111100000110011               
   111111111111111111111000000000000000010001               
   100100000101010001010110000000000000000001               
   100000000001000000000100000001000000000001               
   101111001111000000000100000001111001100011               
   100001000101010000010100000000000001000001111111111111   
   100111100000010000110100000000000001000000000101010101   
   100100000000010000010100000000000001010100000100010001   
   110111100011110000011111100110000101111110000111010011   
   100101000000000001000001000100010101000100000000010001   
   110001000000000011000000011110011111011110000001110011   
   100000010001000001010000010100010000000100000001000001   
   111111011001001101011000010001000011110000000000000001   
   100001000001000100000000010001000001000000000000000101   
   100000010001000101110000011111000001000000000000000101   
   111111111111100101010001000001000001000001000000011111   
               11110001100111100100011111000101110011       
               10010000000100000101000101000101000001       
               11010111111100001111110001110000011111       
               10000100000100000000000000010000000001       
               11110111010100000101110000110011011111       
               10010100010100010101000000010001010001       
               10000001010000010101010100000001010101       
               11111111111111111111111111111111111111  