NO imgs/xpm/wall/default_junglewood.xpm
SO imgs/xpm/wall/default_junglewood.xpm
EA imgs/xpm/wall/default_junglewood.xpm
WE imgs/xpm/wall/default_junglewood.xpm
F 255,0,0
C 0,0,255
KEY 128,600
LAMP 192,560
HEAL 320,520
FULL_HEAL 320,480
FULL_HEAL 448,128
BONUSHP 384,440
ENERGY 448,400
BIG_ENERGY 512,360
GHOST 512,900

11111111111111
10010000000031
10010000000001
10010000000001
10000000000011
10000000000001
100000E0000001
10000000010001
11110000010001
10000000011111
10000010000001
10000010000001
11111111111111
